111111111111111111111111112000000011110000000011110220030011110400000011110000000011110000000011110000000011110000000011111111111111111111111111
111111111111111111111111113000000011110000000011110220030011110400000011110000000011110000000011110000000011110000000011111111111111111111111111
111111111111111111111111114000000011110000000011110220030011110400000011110000000011110000000011110000000011110000000011111111111111111111111111
111111111111111111111111111000000011110000000011110220030011110400000011110000000011110000000011110000000011110000000011111111111111111111111111
111111111111111111111111110000000011110000000011110220030011110400000011110000000011110000000011110000000011110000000011111111111111111111111111